#Akkadian-Sumero symbols.dic
#A part of NonVisual Desktop Access (NVDA)
#URL: http://www.nvda-project.org/
#Copyright (c) 2024Matthew Yeater and Paul Geoghegan.
#This file is covered by the GNU General Public License.

𒍲	ab2xa	most	always
𒀙	ab2xme+en	most	always
𒀛	ab2xtak4	most	always
𒀊	abba	most	always
𒀕	abgunu	most	always
𒀳	absin	most	always
𒀋	abxash2	most	always
𒀌	abxdun3gunu	most	always
𒀎	abxgan2tenu	most	always
𒀐	abxigigunu	most	always
𒀑	abximin	most	always
𒀒	abxlagab	most	always
𒍱	abxnun	most	always
𒀓	abxshesh	most	always
𒇽	ad	most	always
𒄠	adar2	most	always
𒀜	adda	most	always
𒀝	ag	most	always
𒉙	ag	most	always
𒀂	agam	most	always
𒄴	ah	most	always
𒀟	akxshita+gish	most	always
𒀠	al	most	always
𒆘	alad	most	always
𒆗	alad2	most	always
𒀩	alan	most	always
𒉅	alla	most	always
𒀡	alxal	most	always
𒀢	alxdim2	most	always
𒀣	alxgish	most	always
𒀤	alxha	most	always
𒀥	alxkad3	most	always
𒀦	alxki	most	always
𒀨	alxush	most	always
𒂼	ama	most	always
𒍳	amarxkug	most	always
𒁦	amash	most	always
𒆹	ambar	most	always
𒀭	an	most	always
𒀰	an+nagaopposingan+naga	most	always
𒀮	an/an	most	always
𒅈	ar	most	always
𒌓	ar2	most	always
𒀴	arad	most	always
𒀵	aradxkur	most	always
𒃣	arhush	most	always
𒍟	as4	most	always
𒀷	asal2	most	always
𒄬	ash	most	always
𒀾	ash2	most	always
𒀿	ashgab	most	always
𒀺	ashkabatenu	most	always
𒀻	ashtug2/tug2	most	always
𒂤	asilal4	most	always
𒀃	axgan2tenu	most	always
𒀆	axlagargunu	most	always
𒀇	axmush	most	always
𒀈	axsag	most	always
𒊎	az	most	always
𒈑	azlag7	most	always
𒉚	azu	most	always
𒌔	babbar	most	always
𒁁	bad	most	always
𒇵	bafromganba	most	always
𒁂	bag3	most	always
𒁃	bahar2	most	always
𒁄	bal	most	always
𒁅	bal/bal	most	always
𒍏	banshur	most	always
𒁇	bar	most	always
𒁈	barag	most	always
𒁉	be2	most	always
𒉉	bi2	most	always
𒉌	bil	most	always
𒄵	bir	most	always
𒊷	bir6	most	always
𒄡	bisheba3	most	always
𒁊	bixa	most	always
𒂁	bixa	most	always
𒁋	bixgar	most	always
𒁌	bixigigunu	most	always
𒁎	bu/buab	most	always
𒁏	bu/buun	most	always
𒁐	bucrossingbu	most	always
𒋥	bugunu	most	always
𒇧	bul	most	always
𒁑	bulug	most	always
𒁒	bulug/bulug	most	always
𒅮	bun2	most	always
𒌶	bur/bur	most	always
𒌌	bur3	most	always
𒂘	buru14	most	always
𒁳	dab	most	always
𒈙	dadrum	most	always
𒍵	dag3	most	always
𒁗	dagkisim5xa+mash	most	always
𒁘	dagkisim5xamar	most	always
𒁙	dagkisim5xbalag	most	always
𒁚	dagkisim5xbi	most	always
𒁜	dagkisim5xga+mash	most	always
𒁝	dagkisim5xgi	most	always
𒁠	dagkisim5xha	most	always
𒁣	dagkisim5xkak	most	always
𒁤	dagkisim5xla	most	always
𒁧	dagkisim5xlum	most	always
𒁨	dagkisim5xne	most	always
𒁩	dagkisim5xpap+pap	most	always
𒁪	dagkisim5xsi	most	always
𒁫	dagkisim5xtak4	most	always
𒁬	dagkisim5xu2+gir2	most	always
𒍴	dagkisim5xu2+mash	most	always
𒁭	dagkisim5xush	most	always
𒊒	dal	most	always
𒅐	dalhamun6	most	always
𒁮	dam	most	always
𒁷	dan5	most	always
𒁱	dara4	most	always
𒁲	de	most	always
𒌥	de2	most	always
𒁶	dem2	most	always
𒋿	di	most	always
𒀸	dili	most	always
𒇻	dilim	most	always
𒁴	dim	most	always
𒈖	dim3	most	always
𒁸	dinkaskalugunudish	most	always
𒍶	dish+shu	most	always
𒀹	dishtenu	most	always
𒀱	dnaga	most	always
𒀲	donkey	most	always
𒁺	du	most	always
𒄭	du10	most	always
𒌈	du12	most	always
𒌊	du13	most	always
𒈍	du14	most	always
𒄰	du15	most	always
𒌘	du16	most	always
𒌤	du19	most	always
𒌆	du2	most	always
𒀀	du2	most	always
𒁕	du20	most	always
𒌉	du4	most	always
𒂅	du5	most	always
𒇰	du6	most	always
𒁔	du9	most	always
𒂀	dub2	most	always
𒁆	dub2	most	always
𒄶	dubur	most	always
𒁿	dubxesh2	most	always
𒍷	dubxshe	most	always
𒂂	dugud	most	always
𒂃	duh	most	always
𒊩	dul3	most	always
𒂈	dul4	most	always
𒂆	dun3gunu	most	always
𒄙	dur	most	always
𒆪	dur	most	always
𒂉	duru2	most	always
𒂊	e	most	always
𒂌	e/enun/nun	most	always
𒂍	e2	most	always
𒂎	e2xa+ha+da	most	always
𒂏	e2xgar	most	always
𒂐	e2xmi	most	always
𒂑	e2xsal	most	always
𒂒	e2xshe	most	always
𒂓	e2xu	most	always
𒀉	ed	most	always
𒂔	eden	most	always
𒀁	eduru	most	always
𒂕	egir	most	always
𒅎	em	most	always
𒅴	eme	most	always
𒂗	en	most	always
𒂛	encrossingen	most	always
𒇉	engur	most	always
𒂜	enopposingen	most	always
𒂝	ensquared	most	always
𒂙	enxgan2tenu	most	always
𒂚	enxme	most	always
𒂞	eren	most	always
𒉤	eridu	most	always
𒂟	erim	most	always
𒃥	esag2	most	always
𒌎	esh	most	always
𒀼	esh16	most	always
𒇶	esh22	most	always
𒂋	expap	most	always
𒂢	ezenxa	most	always
𒂥	ezenxan	most	always
𒂧	ezenxdun3gunu	most	always
𒂨	ezenxdun3gunugunu	most	always
𒍸	ezenxgud	most	always
𒂩	ezenxha	most	always
𒂪	ezenxhagunu	most	always
𒂫	ezenxigigunu	most	always
𒂬	ezenxkaskal	most	always
𒂭	ezenxkaskalsquared	most	always
𒂮	ezenxku3	most	always
𒂯	ezenxla	most	always
𒂰	ezenxlalxlal	most	always
𒂱	ezenxli	most	always
𒂲	ezenxlu	most	always
𒍹	ezenxshe	most	always
𒂳	ezenxu2	most	always
𒂴	ezenxud	most	always
𒂵	ga	most	always
𒂷	ga2	most	always
𒋗	ga2	most	always
𒃭	ga2/ga2	most	always
𒂸	ga2xa+da+ha	most	always
𒂹	ga2xa+ha	most	always
𒂺	ga2xa+igi	most	always
𒂻	ga2xab2tenu+tab	most	always
𒍺	ga2xan+kak+a	most	always
𒂽	ga2xash	most	always
𒍻	ga2xash2	most	always
𒂾	ga2xash2+gal	most	always
𒂿	ga2xbad	most	always
𒃀	ga2xbar+ra	most	always
𒃁	ga2xbur	most	always
𒃂	ga2xbur+ra	most	always
𒃊	ga2xburu14	most	always
𒃃	ga2xda	most	always
𒃄	ga2xdi	most	always
𒃅	ga2xdimxshe	most	always
𒃆	ga2xdub	most	always
𒃇	ga2xel	most	always
𒃈	ga2xel+la	most	always
𒃉	ga2xen	most	always
𒃋	ga2xgan2tenu	most	always
𒃍	ga2xgi	most	always
𒃎	ga2xgi4	most	always
𒃏	ga2xgi4+a	most	always
𒃐	ga2xgir2+su	most	always
𒃑	ga2xha+lu+esh2	most	always
𒃒	ga2xhal	most	always
𒃓	ga2xhal+la	most	always
𒃔	ga2xhi+li	most	always
𒃕	ga2xhub2	most	always
𒃖	ga2xigigunu	most	always
𒃗	ga2xish+hu+ash	most	always
𒃘	ga2xkak	most	always
𒃙	ga2xkaskal	most	always
𒃚	ga2xkid	most	always
𒃛	ga2xkid+lal	most	always
𒃜	ga2xku3+an	most	always
𒃝	ga2xla	most	always
𒃤	ga2xsar	most	always
𒃦	ga2xshe+tur	most	always
𒃧	ga2xshid	most	always
𒃨	ga2xsum	most	always
𒃩	ga2xtak4	most	always
𒃪	ga2xu	most	always
𒃫	ga2xud	most	always
𒃬	ga2xud+du	most	always
𒆏	gab2	most	always
𒃮	gaba	most	always
𒃯	gabacrossinggaba	most	always
𒃰	gad	most	always
𒃱	gad/gadgar/gar	most	always
𒆕	gag	most	always
𒅕	gaggunu	most	always
𒂶	gagunu	most	always
𒃲	gal	most	always
𒋽	gal5	most	always
𒃌	galga	most	always
𒃳	galgad/gadgar/gar	most	always
𒃵	gam	most	always
𒆠	gan/ganba	most	always
𒃷	gan2	most	always
𒃹	gan2/gan2	most	always
𒃺	gan2crossinggan2	most	always
𒃠	ganun	most	always
𒃼	gar3	most	always
𒇑	garim	most	always
𒄤	gaz	most	always
𒃢	gazi	most	always
𒄀	ge	most	always
𒍼	ge22	most	always
𒄄	ge4	most	always
𒄑	gesh	most	always
𒃾	geshtin	most	always
𒃿	geshtinxkur	most	always
𒄃	gi16	most	always
𒈫	gi6	most	always
𒁍	gid2	most	always
𒄇	gidim	most	always
𒉻	gidru	most	always
𒍽	gig	most	always
𒄅	gigi	most	always
𒄆	gigi	most	always
𒇀	gigir	most	always
𒇥	gigir	most	always
𒆳	gin3	most	always
𒄉	gir2gunu	most	always
𒄋	gir3xa+igi	most	always
𒄍	gir3xigi	most	always
𒄎	gir3xlu+igi	most	always
𒄏	gir3xpa	most	always
𒁽	gir5	most	always
𒁼	gir6	most	always
𒄌	giri16	most	always
𒄈	giri2	most	always
𒄐	gisal	most	always
𒄒	gishcrossinggish	most	always
𒄓	gishxbad	most	always
𒄔	gishxtak4	most	always
𒄁	gixe	most	always
𒄂	gixu	most	always
𒄖	gu	most	always
𒈭	gu10	most	always
𒄘	gu2	most	always
𒄚	gu2xkakxigigunu	most	always
𒄛	gu2xnun	most	always
𒄜	gu2xsal+tug2	most	always
𒄞	gu4	most	always
𒅥	gu7	most	always
𒄟	gudxa+kur	most	always
𒈗	gug	most	always
𒁯	gun3	most	always
𒄥	gur	most	always
𒄕	gur17	most	always
𒄦	gur7	most	always
𒄧	gurun	most	always
𒄨	gurush	most	always
𒄫	hagunu	most	always
𒄯	har	most	always
𒈣	hashur	most	always
𒉂	haya238	most	always
𒄳	hixkin	most	always
𒄷	hu	most	always
𒄹	hub2xan	most	always
𒄺	hub2xhal	most	always
𒄻	hub2xkaskal	most	always
𒄼	hub2xlish	most	always
𒄽	hub2xud	most	always
𒌩	hul	most	always
𒄾	hul2	most	always
𒈞	hum	most	always
𒍾	hush	most	always
𒄿	i	most	always
𒉍	i3	most	always
𒅀	ia	most	always
𒅁	ib	most	always
𒁰	ibex	most	always
𒅂	idim	most	always
𒅃	idim/idimbur	most	always
𒅄	idim/idimsquared	most	always
𒅉	igi/igishir/shirud/ud	most	always
𒅅	ik	most	always
𒀧	il	most	always
𒅋	il	most	always
𒅍	il2	most	always
𒅌	ilxgan2tenu	most	always
𒅓	imin	most	always
𒅑	imopposingim	most	always
𒅒	imsquared	most	always
𒅏	imxtak4	most	always
𒅔	in	most	always
𒈺	inanna	most	always
𒅗	inim	most	always
𒀅	ir	most	always
𒀍	irigal	most	always
𒅖	ish	most	always
𒌛	iti	most	always
𒃟	itima	most	always
𒌗	itima2	most	always
𒂡	izin	most	always
𒆍	ka2	most	always
𒆎	ka2crossingka2	most	always
𒆐	kad2	most	always
𒆑	kad3	most	always
𒆒	kad4	most	always
𒆓	kad5	most	always
𒆔	kad5/kad5	most	always
𒆖	kakxigigunu	most	always
𒌧	kalam	most	always
𒆙	kalcrossingkal	most	always
𒆚	kam2	most	always
𒆛	kam4	most	always
𒃶	kan	most	always
𒍰	kapelamite	most	always
𒃸	kar2	most	always
𒆜	kaskal	most	always
𒅙	kaxad	most	always
𒅚	kaxad+ku3	most	always
𒍿	kaxanshe	most	always
𒅛	kaxash2	most	always
𒎀	kaxash3	most	always
𒅝	kaxbalag	most	always
𒅞	kaxbar	most	always
𒅟	kaxbi	most	always
𒅠	kaxerin2	most	always
𒅡	kaxesh2	most	always
𒅢	kaxga	most	always
𒅣	kaxgal	most	always
𒅦	kaxgar+sha3+a	most	always
𒅧	kaxgi	most	always
𒅨	kaxgir2	most	always
𒎁	kaxgish	most	always
𒅩	kaxgish+sar	most	always
𒅪	kaxgishcrossinggish	most	always
𒅫	kaxgu	most	always
𒎂	kaxgud	most	always
𒅬	kaxgur7	most	always
𒎃	kaxhixash2	most	always
𒅭	kaxigi	most	always
𒅯	kaxkak	most	always
𒅰	kaxki	most	always
𒅱	kaxkid	most	always
𒅲	kaxli	most	always
𒅳	kaxlu	most	always
𒎄	kaxlum	most	always
𒅵	kaxme+du	most	always
𒅶	kaxme+gi	most	always
𒅷	kaxme+te	most	always
𒅸	kaxmi	most	always
𒅹	kaxmi+nunuz	most	always
𒅺	kaxne	most	always
𒎅	kaxpa	most	always
𒅼	kaxpi	most	always
𒅽	kaxru	most	always
𒆀	kaxsha	most	always
𒆁	kaxshe	most	always
𒆂	kaxshid	most	always
𒎆	kaxshul	most	always
𒆄	kaxsig	most	always
𒆅	kaxsuhur	most	always
𒆆	kaxtar	most	always
𒎇	kaxtu	most	always
𒆇	kaxu	most	always
𒆈	kaxu2	most	always
𒆉	kaxud	most	always
𒆊	kaxumumxpa	most	always
𒎈	kaxur2	most	always
𒆋	kaxush	most	always
𒆌	kaxzi	most	always
𒆟	kesh2	most	always
𒋻	kid2	most	always
𒀘	kir6	most	always
𒆦	kisal	most	always
𒆧	kish	most	always
𒁞	kishi8	most	always
𒁾	kishib3	most	always
𒆨	kisim5	most	always
𒆩	kisim5/kisim5	most	always
𒆡	kixbad	most	always
𒆢	kixu	most	always
𒆣	kixud	most	always
𒆫	ku/hixash2ku/hixash	most	always
𒆮	ku4variantform	most	always
𒄩	ku6	most	always
𒆯	ku7	most	always
𒆬	kug	most	always
𒆱	kulgunu	most	always
𒄣	kum	most	always
𒆲	kun	most	always
𒆭	kur9	most	always
𒋣	kush	most	always
𒆵	kushu2	most	always
𒆶	kwu318	most	always
𒆷	la	most	always
𒇳	la2	most	always
𒋄	lag	most	always
𒇬	lagabsquared	most	always
𒆺	lagabxa+da+ha	most	always
𒆻	lagabxa+gar	most	always
𒆼	lagabxa+lal	most	always
𒆽	lagabxal	most	always
𒆾	lagabxan	most	always
𒆿	lagabxashzidatenu	most	always
𒇁	lagabxbi	most	always
𒇂	lagabxdar	most	always
𒇃	lagabxen	most	always
𒇄	lagabxga	most	always
𒇅	lagabxgar	most	always
𒎉	lagabxgi	most	always
𒇆	lagabxgud	most	always
𒇇	lagabxgud+gud	most	always
𒇈	lagabxha	most	always
𒇊	lagabxhixnun	most	always
𒇋	lagabxigigunu	most	always
𒇌	lagabxim	most	always
𒇍	lagabxim+ha	most	always
𒇎	lagabxim+lu	most	always
𒇏	lagabxki	most	always
𒇐	lagabxkin	most	always
𒇒	lagabxkul	most	always
𒇓	lagabxkul+hi+a	most	always
𒇕	lagabxlish	most	always
𒇖	lagabxlu	most	always
𒇗	lagabxlul	most	always
𒇘	lagabxme	most	always
𒇙	lagabxme+en	most	always
𒇚	lagabxmush	most	always
𒇜	lagabxshe+sum	most	always
𒇝	lagabxshita+gish+erin2	most	always
𒇞	lagabxshita+gishtenu	most	always
𒇟	lagabxshu2	most	always
𒇠	lagabxshu2+shu2	most	always
𒇢	lagabxtag	most	always
𒇣	lagabxtak4	most	always
𒇤	lagabxte+a+su+na	most	always
𒇦	lagabxu+a	most	always
𒇨	lagabxu2+ash	most	always
𒇪	lagabxud	most	always
𒇫	lagabxush	most	always
𒇭	lagar	most	always
𒇱	lagargunu/lagargunushe	most	always
𒇯	lagarxshe+sum	most	always
𒆴	lahmu	most	always
𒇲	lahshu	most	always
𒉵	lahtan	most	always
𒉷	lahtan2	most	always
𒇴	lal2	most	always
𒋮	lal3	most	always
𒇷	lamxkur+ru	most	always
𒇸	li	most	always
𒀚	libish	most	always
𒀖	lid	most	always
𒇹	lil	most	always
𒆤	lil2	most	always
𒀗	liliz	most	always
𒇺	limmu2	most	always
𒈓	lu2crossinglu2	most	always
𒈔	lu2opposinglu2	most	always
𒎊	lu2sheshigxbad	most	always
𒈕	lu2squared	most	always
𒈒	lu2tenu	most	always
𒇿	lu2xal	most	always
𒈀	lu2xbad	most	always
𒈁	lu2xesh2	most	always
𒎋	lu2xesh2+lal	most	always
𒈂	lu2xesh2tenu	most	always
𒈃	lu2xgan2tenu	most	always
𒈄	lu2xhixbad	most	always
𒈅	lu2xim	most	always
𒈆	lu2xkad2	most	always
𒈇	lu2xkad3	most	always
𒈈	lu2xkad3+ash	most	always
𒈉	lu2xki	most	always
𒈊	lu2xla+ash	most	always
𒈋	lu2xlagab	most	always
𒈌	lu2xme+en	most	always
𒈎	lu2xnu	most	always
𒎌	lu2xshu	most	always
𒈏	lu2xsi+ash	most	always
𒈐	lu2xsik2+bu	most	always
𒈘	lugal	most	always
𒈚	lugalopposinglugal	most	always
𒈛	lugalsheshig	most	always
𒈠	lugud	most	always
𒈜	luh	most	always
𒈟	lum/lum	most	always
𒋜	ma	most	always
𒈡	ma	most	always
𒈤	ma2	most	always
𒈥	mah	most	always
𒈦	mar	most	always
𒈧	mash	most	always
𒈨	mash2	most	always
𒌑	mashgi	most	always
𒈢	maxtak4	most	always
𒈩	me	most	always
𒀞	me3	most	always
𒃞	men	most	always
𒎍	mesh	most	always
𒊪	mi2	most	always
𒈬	min	most	always
𒂇	mir	most	always
𒅿	mu11	most	always
𒊭	mu2	most	always
𒉰	mud3	most	always
𒉺	mud3	most	always
𒉹	mud3	most	always
𒀯	mul	most	always
𒁵	mun	most	always
𒈱	munshub	most	always
𒋟	murgu	most	always
𒈲	murgu2	most	always
𒉡	muru2	most	always
𒈳	mush	most	always
𒈸	mush/mushxa+na	most	always
𒈻	mush3xa	most	always
𒈼	mush3xa+di	most	always
𒈽	mush3xdi	most	always
𒎎	mush3xza	most	always
𒈹	mushcrossingmush	most	always
𒈴	mushxa	most	always
𒈵	mushxkur	most	always
𒈶	mushxza	most	always
𒍘	mutu	most	always
𒈿	na	most	always
𒎏	na4	most	always
𒅘	nag	most	always
𒉄	nagaopposingnaga	most	always
𒉃	nagaxshutenu	most	always
𒉇	nam	most	always
𒌇	nam2	most	always
𒉈	nam2	most	always
𒉆	namnutillu	most	always
𒈝	nar	most	always
𒉊	nexa	most	always
𒉋	nexud	most	always
𒉏	ni2	most	always
𒀶	nig2	most	always
𒁓	nig2gunu	most	always
𒁹	nigida	most	always
𒇔	nigin	most	always
𒆸	nigin2	most	always
𒉑	nimxgan2tenu	most	always
𒉒	nimxgar+gan2tenu	most	always
𒎐	nin	most	always
𒎑	nin9	most	always
𒀏	nina	most	always
𒃻	ninda	most	always
𒉓	ninda2	most	always
𒉔	ninda2xan	most	always
𒉕	ninda2xash	most	always
𒉖	ninda2xash+ash	most	always
𒎒	ninda2xbal	most	always
𒎓	ninda2xgi	most	always
𒉗	ninda2xgud	most	always
𒉘	ninda2xme+gan2tenu	most	always
𒉛	ninda2xshe	most	always
𒉝	ninda2xshe+ash	most	always
𒉞	ninda2xshe+ash+ash	most	always
𒉟	ninda2xu2+ash	most	always
𒉠	ninda2xush	most	always
𒌄	ninni5	most	always
𒉫	nir	most	always
𒉁	nisaba	most	always
𒍒	nita	most	always
𒉎	nixe	most	always
𒉢	nu	most	always
𒎔	nu11rotated90^	most	always
𒉀	nu2	most	always
𒉐	num	most	always
𒆰	numun238	most	always
𒉬	nuncrossingnun	most	always
𒉭	nuncrossingnunlagar/lagar	most	always
𒅻	nundum	most	always
𒉥	nunlagarxgar	most	always
𒉦	nunlagarxmash	most	always
𒉧	nunlagarxsal	most	always
𒉨	nunlagarxsal/nunlagarxsal	most	always
𒉩	nunlagarxush	most	always
𒉪	nuntenu	most	always
𒉮	nunuz	most	always
𒉱	nunuzab2xdug	most	always
𒉲	nunuzab2xgud	most	always
𒉳	nunuzab2xigigunu	most	always
𒉴	nunuzab2xkad3	most	always
𒉶	nunuzab2xne	most	always
𒉸	nunuzab2xu2	most	always
𒈯	oakum	most	always
𒉾	pab	most	always
𒉽	pan	most	always
𒁖	par3	most	always
𒇾	person	most	always
𒉿	pesh2	most	always
𒎕	pesh2	most	always
𒊰	pesh4	most	always
𒊊	picrossingpi	most	always
𒎖	pir2	most	always
𒊋	pirig	most	always
𒄊	pirig	most	always
𒊏	pirigopposingpirig	most	always
𒊌	pirigxkal	most	always
𒊁	pixa	most	always
𒊂	pixab	most	always
𒊃	pixbi	most	always
𒊄	pixbu	most	always
𒊅	pixbu	most	always
𒊆	pixi	most	always
𒊇	pixib	most	always
𒊈	pixu	most	always
𒊉	pixu2	most	always
𒁀	porridge	most	always
𒅤	pu3	most	always
𒊐	ra	most	always
𒊑	rab	most	always
𒁻	re7	most	always
𒌸	ri2	most	always
𒈷	ri8	most	always
𒈪	rid	most	always
𒊓	ru	most	always
𒊔	sa	most	always
𒊖	sag	most	always
𒊨	sag/sag	most	always
𒊸	sag9	most	always
𒆥	saga11	most	always
𒊕	sagnutillu	most	always
𒊗	sagxa	most	always
𒊘	sagxdu	most	always
𒊙	sagxdub	most	always
𒊚	sagxha	most	always
𒎗	sagxigigunu	most	always
𒊛	sagxkak	most	always
𒊜	sagxkur	most	always
𒊝	sagxlum	most	always
𒊞	sagxmi	most	always
𒊟	sagxnun	most	always
𒊠	sagxsal	most	always
𒊡	sagxshid	most	always
𒊢	sagxtab	most	always
𒊣	sagxu2	most	always
𒊤	sagxub	most	always
𒊥	sagxum	most	always
𒊦	sagxur	most	always
𒊧	sagxush	most	always
𒊫	sallagabxash2	most	always
𒊬	sanga2	most	always
𒊮	sha	most	always
𒊱	sha3xbad	most	always
𒊲	sha3xgish	most	always
𒊳	sha3xne	most	always
𒊴	sha3xshu2	most	always
𒊵	sha3xtur	most	always
𒊶	sha3xu	most	always
𒊹	shab6	most	always
𒊯	shag4	most	always
𒉜	sham2	most	always
𒄱	sharxdish	most	always
𒄲	sharxgad	most	always
𒊻	she	most	always
𒊽	she/shegad/gadgar/gar	most	always
𒊾	she/shetab/tabgar/gar	most	always
𒂠	she3	most	always
𒊿	sheg9	most	always
𒊼	shehu	most	always
𒋂	shesh2	most	always
𒋃	sheshlam	most	always
𒅆	shi	most	always
𒋆	shidxim	most	always
𒋇	shim	most	always
𒋈	shimxa	most	always
𒋉	shimxbal	most	always
𒋊	shimxbulug	most	always
𒋋	shimxdin	most	always
𒋌	shimxgar	most	always
𒋍	shimxigi	most	always
𒋎	shimxigigunu	most	always
𒋏	shimxkushu2	most	always
𒋐	shimxlul	most	always
𒋑	shimxmug	most	always
𒋒	shimxsal	most	always
𒋓	shinig	most	always
𒉣	shir	most	always
𒋔	shir	most	always
𒋖	shir/shirbur/bur	most	always
𒋕	shirtenu	most	always
𒋘	shu	most	always
𒋙	shu/shu	most	always
𒋚	shu2	most	always
𒆝	shubtu6	most	always
𒆞	shubtu7	most	always
𒋛	shubur	most	always
𒆃	shudu	most	always
𒉼	shuk	most	always
𒂄	shul	most	always
𒋨	shum2	most	always
𒀽	shushur2	most	always
𒋞	sig	most	always
𒋡	sig2	most	always
𒋠	sig4/sig4shu2	most	always
𒅊	sig7	most	always
𒂖	sikil	most	always
𒂣	sil7	most	always
𒋢	sila3	most	always
𒀬	siskur	most	always
𒍫	su	most	always
𒋤	su/su	most	always
𒋝	su4	most	always
𒅾	su6	most	always
𒇮	su7	most	always
𒋦	sud2	most	always
𒄗	suh	most	always
𒈾	suh	most	always
𒋧	suhur	most	always
𒃴	sukud	most	always
𒋩	sumash	most	always
𒄢	sun2	most	always
𒋪	sur	most	always
𒄮	sur3	most	always
𒋫	sur9	most	always
𒋀	suxa	most	always
𒋭	ta	most	always
𒋬	ta	most	always
𒋱	tab	most	always
𒋲	tab/tabni/nidish/dish	most	always
𒋳	tabsquared	most	always
𒋴	tag	most	always
𒋰	tagunu	most	always
𒋵	tagxbi	most	always
𒋶	tagxgud	most	always
𒋷	tagxshe	most	always
𒋸	tagxshu	most	always
𒋹	tagxtug2	most	always
𒋺	tagxud	most	always
𒈮	tah	most	always
𒊀	tal2	most	always
𒋼	tar	most	always
𒋯	taxmi	most	always
𒊺	ti2	most	always
𒎘	ti2	most	always
𒌁	til	most	always
𒌂	tir	most	always
𒌅	tir/tirgad/gadgar/gar	most	always
𒌃	tirxtak4	most	always
𒌀	titenu	most	always
𒄸	tu11	most	always
𒌋	tur/turza/za	most	always
𒌏	u/upa/pagar/gar	most	always
𒌐	u/usur/sur	most	always
𒌒	u2	most	always
𒅇	u3	most	always
𒁛	ubur	most	always
𒁥	ubur2	most	always
𒁡	ubur3	most	always
𒁢	ubur4	most	always
𒌚	udgunu	most	always
𒌜	udsheshigxbad	most	always
𒇼	udu	most	always
𒇛	udub	most	always
𒌝	udug	most	always
𒌖	udxbad	most	always
𒌙	udxu+u+ugunu	most	always
𒊍	ug	most	always
𒂦	ug5	most	always
𒃽	ugunu	most	always
𒌕	uh2	most	always
𒌻	ukkin	most	always
𒌍	ul	most	always
𒍈	ulu3	most	always
𒌞	um	most	always
𒌣	umbin	most	always
𒋅	umbisag2	most	always
𒌦	umumxpa	most	always
𒌟	umxlagab	most	always
𒎙	umxme	most	always
𒌠	umxme+da	most	always
𒌡	umxsha3	most	always
𒌢	umxu	most	always
𒌨	ungunu	most	always
𒀔	unug	most	always
𒌬	ur2	most	always
𒌭	ur2xa+ha	most	always
𒌮	ur2xa+na	most	always
𒌯	ur2xal	most	always
𒌰	ur2xha	most	always
𒌱	ur2xnun	most	always
𒌲	ur2xu2	most	always
𒌳	ur2xu2+ash	most	always
𒌴	ur2xu2+bi	most	always
𒃡	ur3	most	always
𒌵	ur4	most	always
𒌪	urcrossingur	most	always
𒌷	uri3	most	always
𒋁	uri3	most	always
𒌫	ursheshig	most	always
𒋾	uru5	most	always
𒍑	urudaxu	most	always
𒍐	urudu	most	always
𒌹	uruxa	most	always
𒌺	uruxashgab	most	always
𒌼	uruxdun	most	always
𒌽	uruxga	most	always
𒌾	uruxgal	most	always
𒌿	uruxgan2tenu	most	always
𒍀	uruxgar	most	always
𒍁	uruxgu	most	always
𒍂	uruxha	most	always
𒍃	uruxigi	most	always
𒍄	uruxim	most	always
𒍅	uruxish	most	always
𒍆	uruxki	most	always
𒍇	uruxlum	most	always
𒍉	uruxpa	most	always
𒍊	uruxshe	most	always
𒍋	uruxsig4	most	always
𒍌	uruxtu	most	always
𒍍	uruxu+gud	most	always
𒍎	uruxud	most	always
𒄝	usan2	most	always
𒉯	usan3	most	always
𒅜	ush11	most	always
𒍙	ushumx	most	always
𒍓	ushxa	most	always
𒍔	ushxku	most	always
𒍕	ushxkur	most	always
𒍖	ushxtak4	most	always
𒍚	utuki	most	always
𒁟	utul5	most	always
𒍛	uz3	most	always
𒍜	uz3xkaskal	most	always
𒍝	uzu	most	always
𒍗	z	most	always
𒍞	za	most	always
𒍡	za3	most	always
𒈰	zadim	most	always
𒀄	zah3	most	always
𒍢	zamx	most	always
𒇡	zar	most	always
𒍠	zasquaredxkur	most	always
𒍤	ze1	most	always
𒍥	zi/zi	most	always
𒍣	zi2	most	always
𒍦	zi3	most	always
𒍧	zib	most	always
𒍨	zibkabatenu	most	always
𒍩	zik	most	always
𒍪	ziz2	most	always
𒍬	zu5	most	always
𒍭	zu5xa	most	always
𒄪	zubud	most	always
𒍮	zubur	most	always
𒍯	zum	most	always
𒀫	zur	most	always
